#uuid#194c6e16-3c56-4689-8e15-fdd69d10bfb3
#name#3
#title#Three
#difficulty#0
#data#
0000000000000000
0000000000000000
0000000000000000
0000000000000000
000?XX00??00?X00
00??0X0?0?0X0X00
00?00X0?0?0X0X00
00?00?0?0?0?0X00
00?00?0?0?0?0X00
00?00?0?0?0?0X00
00?00X0?0?0X0X00
00?00X0?0?0X0X00
00????0???0???00
0000000000000000
0000000000000000
0000000000000000
