#uuid#5217d6d1-6480-4638-af6b-58ff96ad805e
#name#6
#title#Six
#difficulty#0
#data#
0000000000000000
0000000000000000
0000000000000000
0000000000000000
00????00??????X0
00X00?00X0XX00X0
00X00?00X0XX00X0
000?00??0X0X00X0
000?00??0X0X00X0
0000X000?00?00?0
0000X000?00?00?0
00000X0?000?00?0
00000X0?000X00?0
000000X0000XXXX0
0000000000000000
0000000000000000
