#uuid#b30124cb-6895-4fc9-b9d2-60428c8b64d9
#name#9
#title#Nine
#difficulty#0
#data#
0000000000000000
0000000000000000
0000000000000000
0000000000000000
0000000000000000
00X0X00X00000+00
00?0?000?000?000
00?0?00?0X0X0?00
00X0X000X0X0X000
00X0X000X0X0X000
00?0?00?0X0X0?00
00?0?000?000?000
00+0X00X00000+00
0000000000000000
0000000000000000
0000000000000000
