#uuid#f8e091d7-1bc8-452b-a064-f88ee643a3af
#name#amphora
#title#Amphora
#difficulty#0
#data#
0000000000000000
00?0000000000000
0??000000??00000
000?00?0000?0000
0000??00000?0000
0000?XX000000000
000?0XXX00000000
000000XXX0000000
0000000XXX000000
0?000000XXX00000
00?00?000XXX0000
000??00000XX0000
000000000000X000
0000000000000X00
0000000000000000
0000000000000000
