#uuid#ab274769-d204-44f2-8b9f-a0ee8803558a
#name#anubis
#title#Anubis
#difficulty#0
#data#
0000000000000000
00000XX000000000
00000XX000000000
00000XX000000000
0000?0X000000000
0000?00?00000000
00??0??0??000000
0?00?0?000??0000
?0??000???00??00
??0?0?00?00000??
00?0?0??0XXXXXX0
000?0?00?0000000
000XX0?0X0000000
000XX00XX0000000
000XX00X0X000000
000XX000XX000000
