#uuid#572b2a41-4a69-48d2-b4a4-4db75e81e9d7
#name#anvil
#title#Anvil
#difficulty#0
#data#
0000000000000000
0000000000000000
0000000000000000
0000000000000000
0000000000000000
0XXXXXXXXXXXXX00
000?00000000?000
0000?000000?0000
00000X00000X0000
000000?00??00000
0000000??0000000
000000X00X000000
00000XX00XX00000
0000000000000000
0000000000000000
0000000000000000
