#uuid#71eeb36d-a53e-422f-8ea1-676d0427f95f
#name#apple2
#title#Sweet Apple
#difficulty#0
#data#
0000000000000000
0000000000000000
0000000X?0000000
0000000X00000000
000XXX0X00XX0000
00X000XX0X00?000
0X00X0000000?000
0X0X00000???0000
0X0X0000??0X0000
0X000000??X00000
0X000000??X00000
0X0000000?X00000
00X0000000?00000
000XX000000?0000
00000??????00000
0000000000000000
