#uuid#ad4668a7-572c-4559-b7a0-f4f50937f304
#name#aqueduct
#title#Aqueduct
#difficulty#0
#data#
0000000000000000
0000000000000000
0000000000000000
0000000000000000
0000000000000000
???00000XXX00000
000?000X000X000?
0000X0X00000X0X0
0000X0X00000X0X0
0000X0X00000X0X0
0000X0X00000X0X0
0000000000000000
??00000???00000?
00?000?000?000?0
000?0?00000X0X00
000?0?00000X0X00
