#uuid#48365e3f-83aa-40f4-bbdf-4957a7d699cb
#name#arena
#title#The Colosseum
#difficulty#0
#data#
0000X???X??X0000
00???000?00???00
0?00?000?00?00?0
?0?00??????00?0X
X00??000000??00?
XX?0000000000?XX
X0XX00000000XX0X
0000?XXXXX??0000
XX000000000000XX
X00X00000000X00X
X00000X00X00000X
X00000000000000X
X00000000000000X
0X000000000000X0
00XX00000000XX00
0000?XXXXX??0000
