#uuid#1ad1f32e-4fb9-4677-9bc1-540721dae0e8
#name#axe
#title#Flying Axe
#difficulty#0
#data#
0000000000X00000
000000000XX0XX00
00000000XX0X0X00
0000000000X00XX0
0000000000X0X00X
000000000???00?0
00000000?X0X0?00
0000000??00X?000
000000??000X0000
00000??000000000
0000??0000000000
000?0?0000000000
00?0?00000000000
0X0?000000000000
0X?0000000000000
0000000000000000
