#uuid#5d08298c-d3f8-48f6-8bd2-d257dbde95d3
#name#balance
#title#Scales
#difficulty#0
#data#
0000000000000000
0000000X00000000
00000?XXX?000000
0000?00X00??0000
00??00000000?000
000?00000000?000
00??0000000?0?00
0?00?000000?0?00
0?00?00000?00?00
0?00?00000?000?0
?0000?0000?000?0
XXXXXX000XXXXXX0
0XXXX00000XXXX00
0000000000000000
0000000000000000
0000000000000000
