#uuid#48a311b9-06b2-4b58-beeb-c7263529ac30
#name#barbarian
#title#Barbarian Chief
#difficulty#0
#data#
0000000000000000
0000000000000000
0000X00000000?00
0X0X0000X?000?00
0X0X000X00?000?0
0X00XXX0000XXX00
0X0000XXXXXX0000
00X0000000000000
00X0000000000000
00X0000000000000
00X0000000000000
00X000000000XXXX
00X00000000X0000
00X0000000X00000
000X00000X000000
000X00000X000000
