#uuid#05e6b993-4960-47af-8766-4111d8992f36
#name#bat
#title#Creepy Bat
#difficulty#0
#data#
0000000000000000
0000000000000000
0000000000000000
0000XX0000000000
000X0X0000000000
00X00000?0000000
0X00?000?0?00?00
0X0?????0??000X0
0XX???000??0?0X0
X0000?00??0XX?X0
?00000??0000X?X0
0X0000?000000?00
0000000000000?00
00000000000??000
0000000000000000
0000000000000000
