#uuid#a0664f0a-bfc9-4867-9849-edac53387665
#name#bee
#title#Bee
#difficulty#0
#data#
0000000000000000
0000000000000000
0000X00000000000
000XXX000XX???00
000XXX0XXX000X00
000XXXX000X00X00
000XXX0X000?0?00
0000??00?000?000
0000??X00XXXX000
000X000XXXXXX?00
000?0000XXXXX000
000?000X00000000
0000??X000000000
0000000000000000
0000000000000000
0000000000000000
