#uuid#83f5dbbc-dd9e-4255-9519-3a6d70a45ce2
#name#billhook
#title#Sickle
#difficulty#0
#data#
0000000?XXXXX000
000000?000000X00
00000?0000????X0
0000?000??0000X0
0000X00?00000000
0000X00?00000000
0000X00?00000000
00000X0?00000000
00000X0?00000000
000000XX00000000
0000000000000000
00000XX000000000
0000X0X000000000
00XX0X0000000000
00X0X00000000000
000XX00000000000
