#uuid#375b11f5-37b3-49d1-877e-8680db60b3e3
#name#billhook2
#title#Billhook
#difficulty#0
#data#
0000000000000000
000XXXX000000000
00X0000XX0000000
0X0XXXX0?0000000
0XX000X?0?000000
0X00000?0X000000
0000000?0X000000
000000?00X000000
0000000?0?000000
0000000?0?000000
00000000X0?00000
000000000?0X0000
0000000000?0?000
0000000000?0?000
00000000000X0X00
000000000000X000
