#uuid#e1688f9d-3b00-48df-a2e2-9674d9c04965
#name#boar
#title#Wild Boar
#difficulty#0
#data#
0000000000000000
0000000000000000
0000000000000000
0000000000000000
00000?X000000000
0000?00??0000000
00XX0?000XXX0000
0?0000000000X000
0XXXX?000000X000
000000XXXXX00X00
000000XX000XX000
000000XX000XX000
0000000X0000X000
0000000000000000
0000000000000000
0000000000000000
