#uuid#6b201ff2-e4d1-49f2-979c-73545a5711b3
#name#bow
#title#Bow & Arrows
#difficulty#0
#data#
0000000000000000
0?00000000000000
0XXXXX0000000000
000X00XXX0000000
0000?00000000000
00000?0000000000
000000X000000000
000X000X0000X000
00000000X000X000
000X00X00X00X000
0000000000?00X00
000X0X00000?0X00
000X0X000000XX00
0X00000000000X00
00?X0X0000000X?0
0XXX000000000000
