#uuid#9c63b752-03c7-4090-b530-4e0096568644
#name#bread
#title#Loaf of Bread
#difficulty#0
#data#
0000000000000000
0000000000000000
0000000000000000
000000XXXXXX0000
0000XX000000X000
000X000000000X00
00X0XXX000000X00
0?00000X00000X00
0?000000X0000X00
00000000X000XXXX
0?000000X00XXXXX
00?00000X0XXXXXX
000??00X0XXXXXXX
00000XXXXXXXXXXX
0000000000000000
0000000000000000
