#uuid#1cde0834-c2ec-4019-b5b4-a5bf860df353
#name#bull
#title#Bull
#difficulty#0
#data#
0000000000000000
0000000000000000
0000000000000000
0000000000???0??
0XXXXXXXXX0?0??0
0000000000?0X0X0
0XX00000000??0?0
0X0XX000000?0??0
0XXX0XXXXXX00000
XX0X0000X0X00000
X00XX000X00X0000
0X00X00XX000X000
XXXXXXXXXXXXXXX0
0000XXXXXXX00000
0000000000000000
0000000000000000
