#uuid#161747e9-6e49-4d6a-b4eb-b0d57bf95c4e
#name#bunch
#title#Bunch of Flowers
#difficulty#0
#data#
0000000000000000
0000000000X00000
000000000?0X0000
0000000000X00000
000X000000000000
00X0X00000000000
000?0000?0000000
0000000X0?000000
00000000X0000000
0000000000000000
0000?XXX00000000
0000X000XX000000
0000X00000X00000
00000X000X000000
000000XXX0000000
0000000000000000
