#uuid#18572987-62ff-4ebb-9992-04a0d3b11416
#name#butterfly
#title#Butterfly
#difficulty#0
#data#
0000000000000000
0000000000000000
000XXX0000000000
000X00X000000000
000X00X0000000X0
000X000X0000XX0X
0000X00X00??000?
0000X00XXX0000X0
000X0000X0000X00
000X00XXXX00X000
000X0X000X00X000
00XXX0000X00X000
0XX0000000?X0000
XX00000000??0000
00000000000X0000
00000000000X0000
