#uuid#e0366de5-5be3-4b9f-82a0-b811d37c5ee7
#name#camel
#title#Camel
#difficulty#0
#data#
0000000000000000
000XX00000000000
0XX0X00000000000
XXX0X00000000000
000XX000XX000000
000??00?00?00000
00XX00?0000?0000
00XXXX000000X000
000X00000000XX00
00000000??00X0X0
0000XX0?00?0X0X0
00000XX000XX0000
00000XX000XX0000
00000XX000XX0000
00000XX000XX0000
000000X0000X0000
