#uuid#f5bb0c93-24c6-4ccd-9950-503527d2e4d2
#name#camp
#title#Camping in Style
#difficulty#0
#data#
0000000000000000
00000000S0000000
0000000X0X000000
0000000X0X000000
000000X000X00000
000000X000X00000
00000X00000X0000
0000X0000000X000
00SS0000S0000SS0
000SSXXXXXXXS000
0000000000000000
0000000000000000
0000000000000000
0000000000000000
0000000000000000
0000000000000000
