#uuid#81640af2-46db-4b4a-92a7-fbb6d371f3f0
#name#capital
#title#Ionic Capital
#difficulty#0
#data#
0000000000000000
0000000000000000
00000XXXX?XX?XXX
000?XXXXX?XX?XXX
00?S?00000000000
00X?000000XX?XX?
0XX00XXX00XX0XX0
0XX0XXXXX0XX0XX0
0XX0XX00X?XX0XX0
0XX00XX0X?XX0XX0
00??000XX0XX0XX0
000??XXX00XX0XX0
0000?XX000XX0XX0
0000000000XX0XX0
0000000000XX0XX0
0000000000XX0XX0
