#uuid#fc288816-b69d-41bd-ba21-65440bfde369
#name#cart
#title#Cart
#difficulty#0
#data#
0000000000000000
0000000000000000
0000000000000000
000000?000000000
000?0???0?000000
000??0X0???0?000
00??00X00X0??000
??0X00X00X00X000
X00X00X00X00XX00
0X0X0???0X00XX00
0X0X?0?0?X0XXXX0
00??0???0??X00XX
000?00?00?00000X
000?0?0?0?000000
0000?000?0000000
00000???00000000
