#uuid#eb39f7d2-adf3-4241-8d83-a2621e2c41f6
#name#cat
#title#Kitty Cat
#difficulty#0
#data#
0000000000000000
0000000000000000
000X000000000X00
000X??000000??00
000X00XXXX0?0X00
000?000000?0X000
000?00000000X000
000?000000000000
000?00X000X0X000
000?00X000X0X000
000?000000000000
0000X000X00X0000
0000X00X0X0X0000
000X0000000X0000
000X0000000X0000
000X0000000X0000
