#uuid#805653a4-2859-422f-883c-06d2e2bb6b32
#name#cat_sphynx
#title#Scary Cat
#difficulty#0
#data#
000000000000X000
000000000000X000
00000000000XX000
XX000000000X0X00
0XXX000000X00X00
0X00X00XXX000X00
00X00??000000X00
000X000000000X00
000?0000000?0X00
0000?0?000??0X00
0000???000?00X00
0000?0000000?000
00000?000000?000
000000?0XX0?0000
0000000?XX?00000
00000000XX000000
