#uuid#dc4ec063-a65a-4ab2-aacf-e1a79d4c9aa0
#name#catapult
#title#Catapult
#difficulty#0
#data#
0000000000000000
0000000000000000
0000000000000000
0000000000000000
0000000000000000
000XX00000000000
00X00X0000000000
00XX0X0000X?X?00
00????00000??000
000000?000?0X000
0000000???00?000
000XX000X0X0XX00
00XXXXXXX?X?XXX0
000XX0000000XX00
0000000000000000
0000000000000000
