#uuid#89316cd1-942d-4386-9d23-be14cc22597f
#name#centaur
#title#Centaur
#difficulty#0
#data#
0000000000?00000
00000000??000000
000000000?000000
0000000?000X0?00
00000000000X??00
00000000000X0?00
0000?S0000?000X0
00XX00????00S0?0
0X000000000X0XX0
XX000000000X0000
X0X00X0000XX0000
00XX00XXX00X0000
0XXX000000???000
XX00S0000?000?X0
00000X000?0000X0
00000X00X0000000
