#uuid#9343d4ff-b775-460d-a8d3-9bedbb5fb430
#name#chair
#title#Chair
#difficulty#0
#data#
0000000000000000
0000000000000000
0000000000000000
0000000000000000
0XX0000000000XX0
0XX0000000000XX0
00XX00000000XX00
??XX????????XX??
000XX0XXXX0XX000
000XX00XX00XX000
000X0??????0?000
000?00000000X000
0XX0000000000XX0
XXX0000000000XXX
0000000000000000
0000000000000000
