#uuid#0db324de-61e4-4d41-b0ed-6f90e63c9334
#name#chain
#title#Chain
#difficulty#0
#data#
0000000000000000
000000000000X??0
0000X?XX0000X0?0
0000?00X0000X0X0
0000??XX0000X??0
0000000000000000
0000000000000000
00000???00000000
X??00?0?000???00
X0X00X0?000X0?00
?0?00?X?000XXX00
XXX0000000000000
000X?XX?00000000
000X000?00000000
000X?XX?00000000
0000000000000000
