#uuid#6d0449bb-9782-43a8-8116-d3c769d9d40f
#name#cheese
#title#Smile!
#difficulty#0
#data#
0000000000000000
00000000XX?00000
000000XX000X0000
000000?00000X000
00000X0000000X00
00000X0000?X00X0
0000X00000??XXX0
0000X000XXX000X0
000?00?XX000XXX0
000XXX000XX?00?0
000?00???00000?0
000???000000X?X0
000?0000X?X?0000
000?0X?X00000000
000?X00000000000
0000000000000000
