#uuid#3e61ba4d-2683-4851-8cb5-14c44d31df31
#name#cherry
#title#Cherries
#difficulty#0
#data#
00000000X0000000
00000000X0000000
00000000X0000000
0000000X0X000000
0000000X0X000000
0000000X0X000000
000000X000X00000
000000X000X00000
00000??000X00000
00XX?X0000X???00
0X00?000000X00X0
X0000X0000X0000X
X0000X0000X0000X
?0000X0000X0000X
0X00?000000X00X0
00??00000000??00
