#uuid#cc439b20-2941-4ddf-b3cf-b768fbc5fe14
#name#chest
#title#Treasure Chest
#difficulty#0
#data#
0000000000000000
00000000XXXX0000
0000??XX0000?000
000X000000000?00
0000X00000000?00
00000?00000000?0
00000?000000??X0
0000XXX000XX00X0
00XX000XXX0000X0
0X00XXXX000000X0
0X00000X000000X0
0X00000X000000X0
0X00000X0000??00
00??000000??0000
0000??XXXX000000
0000000000000000
