#uuid#26a0b0b5-09b0-4485-90c6-7a9061a2cf5d
#name#cloud
#title#The Sky
#difficulty#0
#data#
X???000000000000
???00000?X00000?
X000000X?XXXX?XX
0000X00X?XXXX?XX
000???XX?XXXX?XX
000XX?XX?XXXX?XX
000000XX?XXXX000
0000000X000XX000
000X00000000000X
XX0XX000000000XX
????0??00000??XX
XX?X??0000000000
000000000000000X
0??00000000???XX
00?X?00000??0000
0X?X??X?00000000
