#uuid#38393e95-94bc-4fc9-9f47-692b7afc7552
#name#clover
#title#Four Leaf Clover
#difficulty#0
#data#
00000000XX000000
0000000X00X00000
00XX000X000X0000
0X00?00X0000X000
?0000X0X0000X000
X00000X0000X0000
0X00000000X00000
00??0000000XX000
0000?00000000?00
000X000000000?00
00X0000XX000X000
00X0000X0XXX0000
000X000X0X000000
0000XXX00X000000
000000000X000000
000000000XX00000
