#uuid#6631b835-f07b-4396-8d96-f5fcdc16a9ee
#name#cobra
#title#Cobra
#difficulty#0
#data#
0000000000000000
0000000000000000
0000000000XXXX00
00000000?S00XXX0
00000000S00?0000
00000000S00?0000
00000000?00?0000
00000000?0?00000
0XXXXX000XX00000
00000XX000XX0000
00000XX0000XX000
0000XX000000X000
000XX0000000XX00
000XXX000000XX00
00000XXXXXXXX000
0000000000000000
