#uuid#17a1e2f0-ca7e-4950-97d0-d86d0fdf9a33
#name#cock
#title#Rooster
#difficulty#0
#data#
0000X00000000000
000XXX0000000000
000X0X0000000000
00XXXX0000000000
00X0X0X00000XXX0
000XX0X0000X00XX
0000X0X000X00X00
000X000X00X00XX0
000X0000XX00X0X0
0000?0000000?000
0000?000000?0000
00000?0000?00000
000000?0??000000
000000X0X0000000
000000X0XX000000
00000XX00X000000
