#uuid#a0150476-f1fd-4d35-b4f3-4023332d8d1d
#name#coin
#title#Coin
#difficulty#0
#data#
0000000000000000
0000000000000000
000000000000X000
0000000000000X00
0000000000?000X0
00000000000?00X0
00000000X00?00X0
0000000000?00XX0
0000?00000?00XX0
0000?00000?00XX0
00000?000000XX00
000000???00XXX00
00X0000000XXX000
000XX00XXXXX0000
00000XXXXX000000
0000000000000000
