#uuid#28afa7ee-8617-4fde-bf31-f777d49956e0
#name#column
#title#Column
#difficulty#3
#data#
0000000000000000
00000S0000000000
00000X0X00000000
0000000000000000
000X0X0X0X000000
0000000S00000000
000X0XSXSX0X0000
0000000S00000000
000X0X0X0X0X0000
0000000000000000
000X0X000X0X0000
000X0X000X000000
0000000000000000
0XXXXXXXXXXXXXX0
0000000000000000
0000000000000000
