#uuid#bc57f394-1875-46d0-9a2f-8c712d8d54d5
#name#comb
#title#Comb
#difficulty#3
#data#
0000XX0000000000
000XXXXXX0000000
000?000XXXXX0000
000??00000XX??00
00X00???00000?00
00X00?00???00?00
00X00?00?00??000
00X00?00?00?0000
00X0000X000?0000
0000000X00X00000
0000000X00X00000
0000000000X00000
0000000000000000
0000000000000000
0000000000000000
0000000000000000
