#uuid#277910b9-9f63-4f00-8576-5971d5566c59
#name#compass
#title#Compass Needle
#difficulty#0
#data#
0000000000000000
0000000000000000
00X0000000000000
00XX000000000000
000XXX0000000000
0000X0X?00000000
0000X000?0000000
00000X000X000000
00000X0000X00000
000000?000?00000
0000000?000?0000
00000000?X0X0000
0000000000XXX000
000000000000XX00
0000000000000X00
0000000000000000
