#uuid#510fb3be-08c0-4bc5-bb2e-49df402c3875
#name#cow
#title#Cow
#difficulty#0
#data#
0000000000000000
0000000000000000
0000000000000000
0000000000000000
0000000000000000
00X00X0000000000
000XX00?XXXX?000
00X00XX000000?00
00X00000000000X0
00XX?000000000?0
0000XXX0XXXXX?X0
0000?0??00?0??X0
0000?0?000000??0
0000?0?0000000X0
000000?000000000
0000000000000000
