#uuid#e90c756b-83f7-40e1-83a9-da5353cc2c0d
#name#crab
#title#Crab
#difficulty#0
#data#
0000000000000000
0000000000000000
00?00000X0000000
00?000?X00000000
?00?0?000000?000
0X00X0000000?000
000000000000?000
00?000000000?000
??00000000000?00
000?000000000?00
00?000000000000X
0X0000000000X??0
000000000?0?0000
000000000?0?0X??
00000000?00?0000
000000000000?000
