#uuid#32430756-498c-48f1-819f-3813865b74d5
#name#crocodile
#title#Crocodile Alert
#difficulty#0
#data#
0X00000000000000
00X0000000000000
X0000XXX000XX000
0?00X000X0X00X0?
00?X00000X000X00
000X00000X0000X0
?00X0000000000X0
0X0X00000XX000X0
000X000XX00000X0
?00X000000000X00
0?00X000XX00?00?
00S00?00000?00?0
000?0?00000?0?00
000000?00S0?0000
0X00000?00S000?0
00?00000XX000X00
