#uuid#d57a1e86-0ba2-4c29-a38e-c1ec2609a45b
#name#crown2
#title#Gold Crown
#difficulty#0
#data#
0000000000000000
0000000000000000
00000?X00X?00000
00X000X00X000X00
0?0X00X00X00X0?0
00?0X?0000?X0?00
000?0?0000?0?000
000?X000000X?000
000?X000000X?000
0000?000000?0000
0000XX0000XX0000
00000X0000X00000
000?00000000?000
000?XX????XX?000
0000000000000000
0000000000000000
