#uuid#7432391c-abc8-4781-99b0-d0256e9d46f7
#name#crown
#title#Corona Civica
#difficulty#0
#data#
0000000000000000
00000?0000000000
0XXX?0000000000X
000X00?00000000?
000X00?000000000
0?0X0?0000000000
0?????0000000000
0000X00?0000000X
0000X??X000000XX
00?????0000000?X
000000XX??0000X?
00000????XX0XXX0
0000000XX0XXX000
00000000000XX000
0000000000XXXX00
000000000XX00XX0
