#uuid#ed1bf4ed-45ec-49e9-b852-080d86e2223c
#name#crow
#title#Crow
#difficulty#0
#data#
0000000000000000
0??0000000000000
00??000000000000
XX00X00000XX0000
0X00X0000?00?000
X0??0X00?000????
0000X0XX000X0000
00000X0000X00000
0000X000000X000?
0000X0000000XX??
0000X000000X000X
000?00000XX0XX0?
00?00000000000??
0X00XXXX000000XX
XX0X000X000000X0
00XX000X00000000
