#uuid#3d2651d4-bdd9-45f1-9762-a59cd9e55961
#name#cushion
#title#Cushion
#difficulty#0
#data#
0000000000000000
0000000000000000
00?0000000000000
000X?X0X?X0X0X?0
000000000000XX00
00X00000000000?0
000000000?0?00X0
0X000??000000000
000?0000000000X0
0X00000000000000
XXX0000000000X00
XX0X000000000000
0000X0X0X?X?XXX?
00000000000000?0
0000000000000000
0000000000000000
