#uuid#5f7483e5-5ed3-4342-b5f6-b3dd3295b5fb
#name#cyclops
#title#Stuffy Cyclops
#difficulty#0
#data#
000000X???000000
0000?X0000??0000
000X00000000X000
000X00000000X000
000X000000000X00
00X00000000000X0
0X0000X000S000X0
00XX000XX0S00XX0
000S000000000X00
000X000000000X00
000X00000000X000
000X00000000X000
000X000XX000X000
000X00000000X000
000X000000?X0000
0000XXXXXXX00000
