#uuid#f5762d59-659d-42ee-ad9c-4423cc4fb0fc
#name#deadtree
#title#Drowned Tree
#difficulty#0
#data#
0000000000000000
0000000000X00000
0000000000X000X0
0X00?0000?000X00
00X00?000?0?0?00
00X000X0X000X000
00X000X0X000X0X0
0X0?00X0X00?XX00
0000?00??0?00000
00000?XXX?000000
0000000XX0000000
0000000XX0000000
000000XXX?000000
000X?X0000?XXX00
XXXX0000000000XX
0000000000000000
