#uuid#4726668b-0870-4716-b2e9-066443f494a4
#name#deer
#title#Deer
#difficulty#0
#data#
0000000000000000
00000?00000000X0
00X0X000000X00X0
000XX00X000?0?00
00000?0?0000?000
000000?000??0000
0000000?0X000000
000000X?X?000000
0000??000X000000
000XXXX?0X000000
0000000?0X000000
0000000?0X000000
000000X00X000000
000000X00X00XXXX
000000X000XX0000
000000X000000000
