#uuid#4248af43-9d75-418a-81cd-cb752a920d7a
#name#dice
#title#Alea Iacta Est
#difficulty#0
#data#
0000000000000000
0000000000000000
0000000000000000
00000XXX00000000
0??XX000XX?X0000
0?000000000?0000
0XXX0000XX0?0000
0X00XXXX000X0000
0X0000X0000X0000
0X0000X0000X0000
0X0000X0000X0000
0X0000X0000?0000
0??000000??00000
000XX0X?X0000000
00000XX000000000
0000000000000000
