#uuid#888cfeb9-29dd-4a0c-9861-8f556efa3f4d
#name#dog
#title#Man's Best Friend
#difficulty#0
#data#
0000000000000000
0000000000000000
0000X00X00000000
0000X0X000000000
000XX0X000000000
000XX0X?00000000
000X0X00?0000000
000X000XS?000000
0X00X0X00S000000
0X000XX??0S00000
XX0XX000??0?0000
00X0X000?0?0??X0
000??0000?0000X0
000X0XXXXX000X00
000X000XX0XXX000
000X000000000000
