#uuid#2925d8a3-c7d2-4133-8bd2-7e0675c75e51
#name#dog2
#title#Greyhound
#difficulty#0
#data#
X000000000000000
0X0X000000000000
00X0X00000000000
0000X000000???00
00000X?000?X0X?0
0X00000?0?00?000
00000000?000?000
00XXXXXX000?0000
00000000000?00?0
0X0XXXX0000X0?0X
0XX0000XXXX0?000
0XX0000000X00000
0X00000000X00000
X000000000X00000
X0000000000X0000
0000000000000000
