#uuid#112d44a4-e3d9-47a5-aa28-51e0a96e8e5b
#name#dolmen
#title#Dolmen
#difficulty#0
#data#
0000000000000000
0000000000000000
0000000000000000
0000000000000000
00X0XXXXXXX0X000
0X0?0000000?0X00
0?000000000000?0
0X000000000000X0
00X00XXXXX000X00
00?0?0XX00?0?000
00X0X0XX00X0X000
00?0?0??00?0?000
00X?X00000X?X000
0000000000000000
0000000000000000
0000000000000000
