#uuid#d66b7f52-7430-469c-9cb5-4904a3fc094e
#name#dolphin
#title#Dolphin
#difficulty#0
#data#
0000000000000000
00000XXX0???0000
000XX000?0?00000
00X00000000X0000
0XXXX0000000X000
00000????XX0X000
00000?00000X0X00
000000000000XX00
0000000000000X00
0000000000000??0
0000000000000?00
0000000000000000
0000000000000000
0000000000X0X0X0
00000000000XXX00
0000000000000000
