#uuid#d12030ea-e4d1-442f-9923-cc312a9d6091
#name#duck
#title#Duck
#difficulty#0
#data#
000000000XXX0000
00000000?0???000
0000000?0?0??000
000000XXX????000
0000XXXXX00X0000
000000000X0X0000
000000000X0X0000
000000000X0X?XXX
00000000X0000000
XX00000X0000?000
XXXX000X000?0000
XXXX???000?00000
0000000X000?????
0000000X00000000
00000000XX??XXXX
0000000000000000
