#uuid#c47207ac-f40f-4157-a498-bb24a5de7947
#name#eagle
#title#Golden Eagle
#difficulty#2
#data#
0000000000000000
0000000000000000
00?0000??00000X0
0??000??X?0000XX
0X0X0000??0000XX
0X0X0000??0000X?
0?00XX0???000?0?
0?0000?000XXX00?
0?0000X000X0000X
0X0000X000X0000X
0X0000X000X0000X
00?000X000X0000X
00?000X00X0000?0
0000000??0000000
00000XX00?XX0000
00000XX000XX0000
