#uuid#c85d5a29-7990-4f9a-bac7-206fe0d08b5c
#name#eagle2
#title#Eagle
#difficulty#0
#data#
0000000000000000
0000000000000000
0000000000000000
0000000000000000
00XX00000000XXX0
00?0?0000000X0X0
000?0?00000X0X00
000?00?X00XXX000
0000X000???00000
00000?00000XXX00
00000??0?0XX0000
000XXX0X0?000000
0000000000000000
0000000000000000
0000000000000000
0000000000000000
