#uuid#83115af6-4ee3-4bbb-8a18-b2f724f33730
#name#elephant
#title#Elephant
#difficulty#0
#data#
0000000000000000
0000?0X?X0?00000
0000?XX?XX?00000
0000???????00000
00000XX?XX000000
00000XX?XX000000
0000000000000000
0000000000000000
0000000000000000
0000000000000000
0000000000000000
XX0000000000XX0X
XX00XXXX00XXXX0X
XX00XXXX00XXX00X
XXXXXXXXXXXXXXXX
XXXXXXXXXXXXXXXX
