#uuid#c1585473-75da-498c-9ea0-2efc13b1ca07
#name#eye
#title#Eye of Horus
#difficulty#0
#data#
0000000000000000
0000000000000000
000000X???S?0000
00000X000000XX00
000XX000000000X0
00X0000000000000
000000XX???X0000
00000X00???0X000
0XXXX000???00XX0
00000000??000S00
00000XX0000XX000
0000000XXXX00000
0000000X00X00000
0XX000X000X00000
0X000X0000X00000
00XXX00000X00000
