#uuid#cb6edb8e-9752-484e-b921-0f3eb2ac4d8a
#name#fir
#title#Fir
#difficulty#0
#data#
0000000?X0000000
0000000??0000000
0000000X?0000000
0000000?00000000
000000??XX000000
000000?0X0000000
00000000X???0000
0000???00?X00000
000000?0X00?0000
000???0XXX??X000
0000?00000?00000
00000XXXX?0XX000
0????0000???XX00
00000????0000000
0000000XX0000000
0000000XX0000000
