#uuid#359b7247-9165-49a8-9a9c-9641dffbfdbb
#name#firejar
#title#Olympic Fire
#difficulty#0
#data#
0000000000000000
0000000000000000
0000000S00000000
00000X000X0?0000
000000S?00000000
0000000SX0X00000
00000?0?000S0000
0000X0XXX0XXX000
0000XXXX00XX0000
0X000000000000?0
00XXXXXXXXXXXX00
00000XXXXXX00000
0000000000000000
00000000X0000000
00000000X0000000
0000000XXX000000
