#uuid#777d7a1e-94c2-488c-b8a7-b3985e8f27e2
#name#fire
#title#Blazing Fire
#difficulty#0
#data#
0000000000000000
0000000000000000
000000000?000000
0000000000000000
0000000000000000
000X000000000000
000X000000000000
000X0000000000X0
000X00000X0000X0
000X00000X000X0X
00X0X0000X000X00
X0X0X0000X000X00
X0X00X000X00X000
X0X000X0?0?0?000
0X00000X000?0000
0000000000000000
