#uuid#1b3dce79-181b-4647-aa78-02401a8f57be
#name#fire2
#title#Campfire
#difficulty#0
#data#
0000000000000000
0000000000000000
00000000?0X00000
0000000?0?000000
000000X0X0000000
000000X0X0000000
00000X000X000000
0000X00000X0X000
000X0000000X0X00
00?000S000000X00
000X0000000X?000
0000XX000XX00000
000000XXX0000000
0000000000000000
0000000000000000
0000000000000000
