#uuid#a984c32e-203d-494a-9735-74d1429898f9
#name#fish
#title#Goldfish
#difficulty#0
#data#
0000000000000000
0000000000000000
0000000000000000
0000000000000000
0000000000000000
00000000XX000000
000000XXXX000000
000XXX000XXX00?0
00?000000000X?00
0?00?000000000?0
00?0000000000?00
000?X00X000XX0?0
00000XXXXXX00000
0000000XX0000000
00000000?0000000
0000000000000000
