#uuid#bc45c662-8ba6-4ecf-b188-ca7d1782d6bc
#name#fish_b
#title#Green Guppy
#difficulty#0
#data#
0000000000000000
0000000000000000
0000000000000X00
000000?X?0000000
000000????000000
0X000X?X0XX000X0
0XX0XX0?0???0000
0XXXXX0X0XXXX000
0XXXXX0X0XX0XX00
0XXXXX0X0XXXXX00
0??00??X0XXXX000
0?0000?X0XX00000
0000000X0X000000
0000000XXX000000
0000000XX0000000
0000000000000000
