#uuid#19e686e1-9d76-44a9-895c-8baaf65e56f3
#name#flash
#title#Lightning Flash
#difficulty#0
#data#
00000000000?00X0
0000000000?X0X00
000000000X000?00
000000000X0XXX00
000000000?00X000
000000000XX0X000
0000XX?X0?0XX000
0000X00XX0X00000
000XX000X0X00000
000?0??000?00000
XXXX0X0XX0X00000
00000?00X0XXX000
XXXX?X0XX000?000
0000000X000??000
00000X?X0?0X0000
00000X00X?0X0000
