#uuid#4e42c5b8-8d7e-46e2-83a4-b7654f49ddcd
#name#flowervase
#title#Vase with Flowers
#difficulty#0
#data#
0000000000000000
0000000000000000
0000000000000000
0000000000000000
0000000000000000
0000000000000000
0000000000000000
0000000000000000
000000X?XX000000
000000X???000000
00000X00XXX00000
0000?00?XXXX0000
0000?0??XXXX0000
0000XXX?XXXX0000
00000XX?XXX00000
0000000000000000
