#uuid#1e7a95f0-e5f6-4330-89cd-0426317caf8c
#name#foghorn
#title#Horn
#difficulty#0
#data#
0000000000000000
0000000000000000
00000000XXX?0000
00000000X000X000
0000000?0?000?00
0000000?00?00X00
0000000?000?XX00
000000?00000?000
000000?0000?0000
00000?000??00000
000??00XX000XX00
XXXXXXX00XXX00X0
0X0000000000000X
0X0000XXX000000X
00XXXX000XX0000X
00000000000XXXX0
