#uuid#5da31b19-e5d4-4bdd-8345-78a83e46d0a0
#name#footprint
#title#Trail
#difficulty#0
#data#
000000000000000?
0000X0XX000000??
000XX0X000000000
00000000?00000??
000XX00??0000???
00XXXX000000000?
000XX00??0000000
0000000?00000000
0000000000000000
0000000000000000
000000?000000000
000X0??000000000
00XX000??0000000
0000000?00000000
0XXXX00000000000
00XXX0X?00000000
