#uuid#5940edff-a87d-48f9-b429-1c47744c46c0
#name#fork
#title#Neptune's Trident
#difficulty#2
#data#
0000000000000000
000?0000?0000?00
00?0?00?0?00?0?0
0X?X?X0???0X?X?X
000?0000?0000?00
000X0000X0000X00
000X0000X0000X00
000X0000X0000X00
000X0000X0000X00
000X0000X0000X00
000X0000X0000X00
000X0000X0000X00
0000?XXXXXXXX000
0000000XXX000000
00000000X0000000
00000000X0000000
