#uuid#e8d74afc-a9aa-4c72-b9ab-2f92d212fd74
#name#fusion
#title#The Forge
#difficulty#0
#data#
?00000X000X00000
00XXX0000X000000
00000000?0000000
0XXX00X?0X000000
?0000?0?XX000000
00XXX0000X000000
?X0000000X000000
000000000XX00000
000000000XX00000
0000000000X00000
0000000000000000
00000000X000X000
000000000XX00X00
0000000XX0000000
00000??000000000
000XX00000000000
