#uuid#5eefc076-447a-4ae5-ae53-294c8ac27f3b
#name#gallichouse
#title#Cottage
#difficulty#0
#data#
0000000000000000
0000000000000000
000000??XX000000
000000?00X000000
0000000?X0000000
00000??00XX00000
0000?000000X0000
000X00000000X000
00X0000000000X00
0X000000000000X0
X00000000000000?
0XXXXXX???XXXXX0
00?0000?0?000?00
00?0000?0?000?00
XX???XX???XXX???
0000000000000000
