#uuid#222d63c1-3c16-4980-abbb-afefed43b782
#name#gladiator
#title#Gladiator
#difficulty#0
#data#
00000000XX000000
00000000X0000000
000000XXX0000000
00000XXXX00?0000
0000XXXXX000?000
0000XX000??00?00
0???000000????00
00?0000?0000???0
0000000?00000??0
0000?0??00000000
0000?0??00000000
0000???000000000
0000??0?00000000
XXXX00??00000000
0XXXX0??000000XX
0XXXXX0000000XXX
