#uuid#193a866d-f96e-498d-8ec3-2e68579719ec
#name#glass
#title#Cup
#difficulty#3
#data#
0000000000000000
0000000000000000
00XXXXXX0XXXXXX0
0000000000000000
000?000?000?0000
0000?000?000?000
0000000000000000
0000000000000000
0000000000000000
00000X00000X0000
000000XXXXX00000
00000000X0000000
00000000X0000000
00000000?X000000
00000000X0000000
000000XXXXX00000
