#uuid#edb52f38-1312-46f0-9412-6251f09b357d
#name#goose
#title#Goose
#difficulty#0
#data#
0000000000000000
00000XX000000000
0000X0X000000000
00XX00X000000000
00000XX000000000
00000XX000000000
00000XX000000000
00000XX000000000
00000XXXX??????0
00000XX0000?00?0
000000X0000?0?00
000000X0000?0?00
0000000X00?0?000
00000000XXXX0000
XXXXXXXXXXXXXXXX
XXXXXXXXXXXXXXXX
