#uuid#aaa869ba-416b-49c1-aeda-0e7ac77a5f1b
#name#ham
#title#Cooked Ham
#difficulty#0
#data#
0000000000000000
0000000000000000
0000000000000000
000?X?X??0000000
00X0000?0?000000
00?00?00?0?00??0
00X0XXX00?0??0X0
0X00XX000X000?00
0X00XXX00X000X00
0X00XXX0X00XX000
0X00XX00X0X00000
0X000000XX000000
00X00000X0000000
000?000?00000000
0000XXX000000000
0000000000000000
