#uuid#1c61113b-b14d-4281-81a5-22d08b349595
#name#hammer
#title#Heavy Hammer
#difficulty#0
#data#
0000000000000000
0000000000000000
0000000000000000
0000000???XXX000
00000??000?0X000
000??0000X00X000
000XXX0XX000?000
000X00X0000?0000
000X00X00XX00000
000X00X0XXX00000
0000XXXXXXX00000
00000000XXX00000
000000000XX00000
000000000XX00000
000000000XX?0000
000000000XX?0000
