#uuid#4923b626-ea71-49a4-8f8b-5396c83e6942
#name#hammer2
#title#Mallet
#difficulty#0
#data#
0000000000000000
00000000XXX00000
0000000X000?0000
000000X00000?000
0000000X00000?00
00000000X00000?0
0000000X00000?00
000000?00??0?000
00000X00X00X0000
0000X00X00000000
000?00?000000000
00X00X0000000000
0X00X00000000000
0?0?000000000000
00X0000000000000
0000000000000000
