#uuid#a3cc7285-a34c-44a4-94f6-be2c7a4f39ed
#name#heart
#title#Hearts
#difficulty#0
#data#
000000XX0X000000
00000X00?0X00000
00000X0000?00000
000000X00X000000
0000000X?0000000
000000000000X0X0
00000000000X0X0X
0?XX000X?00?000?
X000X0X00X00X0X0
X0000X000X000X00
X00000000X000000
X00000000?000000
0?000000?0000000
00X0000X00000000
000X00X000000000
0000XX0000000000
