#uuid#8f7ffb68-8abd-4799-a6ae-eab669f20706
#name#helmet
#title#Silver Helmet
#difficulty#0
#data#
0000000000000000
00000?0000000000
00000?0000000000
00000?0XX?000000
00000?X000X00000
0000???00?0?0??0
000X00000?00XXX0
000X00000?00X000
000000000?00X000
00X00?XXX000X000
000000X0X??00000
00000000X00?X000
0000000000000000
0000000000000000
0000000000000000
0000000000000000
