#uuid#44facc15-47cc-4cef-9b61-5d6321613c8b
#name#helpscreen
#difficulty#0
#data#
0000000000000000
0000000000000000
0000000000000000
000000XX00000000
00000X00X0000000
00000X00X0000000
0000?0000?000000
00XX000000XX0000
0X0000000000X000
0X0000000000X000
00X00000000X0000
000X00XX00X00000
000X0?00?0?00000
000X?0000X?00000
0000000000000000
0000000000000000
