#uuid#78a4f3a0-ff95-4931-8032-458f77d19ee3
#name#heron
#title#Heron
#difficulty#0
#data#
0000000000XX0000
00000000??00XX00
00000XX?00000000
0XXXX000?0XX00X0
?00000000?00000X
XXXXXXXX00?0000X
00000000???XX00X
000000000000X00X
000000000000X00X
00000000000X00X0
0000000000?000X0
0000000000?00X00
000000000?000X00
000000000?000X00
00000000?000X000
00000000?000X000
