#uuid#798fbe4f-1aed-4fd5-84d4-31dce18a4554
#name#horse
#title#Horse
#difficulty#0
#data#
0000000000000000
0000000X00000000
00000000X00X0000
00000000XX0X0000
0000000XXXXX0000
00000?0XXXXXX000
0000?0XXXX0XX000
000?0XXXXXXXX000
00?0XXXXXXXXXX00
00?0XXXX0XXXXX00
0?0XXXXX0000XXX0
0?0XXXX00000XX00
0?0XXXX000000000
0?0XXXX000000000
?0XXXXXX00000000
?0XXXXXXX0000000
