#uuid#932858f5-5b9f-45fc-9018-1402a98fe60a
#name#horseshoe
#title#Horseshoe
#difficulty#0
#data#
0000000000000000
000000????000000
0000??0000??0000
000?--????--?000
000?-?----?-?000
00X0X-0000-X0X00
00X0X-0000-X0X00
00X0X-0--0-X0X00
00X0X-0000-X0X00
00X0X-0000-X0X00
000X0X0000X0X000
000X0X0000X0X000
000X00X00X00X000
0000X0?00?0X0000
00000X?00?X00000
0000000000000000
