#uuid#0a9a7fee-a336-4725-ae1e-8e2259aa58cb
#name#horus
#title#Horus
#difficulty#0
#data#
0000000000000000
0000000000000000
00000XX?XX?00000
0000?000000?0000
000X00000000X000
00X00000XX000XX0
0X00000?XX?00XXX
?00000000X?XXXXX
X000XXX?0X?X000X
XXXXXXX0???00000
XXXXXXX0000XX000
X0000XX0000XX000
00000XX0000XX000
00000XX0000XX000
00000XX0000XX000
00000XX0000XX000
