#uuid#d56ff5fe-cf46-4540-8f45-2cb4845982bb
#name#hourglass_b
#title#Time Passes
#difficulty#0
#data#
00000000???00000
00000???XXX00000
0???XX000?000000
0XXX00000?000000
00?000000?000000
000?00000?000000
0000??00?0000000
000000S0S0000000
0000000S0S?00000
000000?0000?0000
00000?000000?000
00000?000000?000
00000?000000XXX0
00000?000XX????0
0000XXXX???00000
0000????00000000
