#uuid#f3e83a8d-642b-464f-95ef-c0b3f39af53a
#name#hydra
#title#Hydra
#difficulty#2
#data#
0000000000000000
0000000000000000
XX0000000?000000
00?00000?X?00000
XXX??0000?000000
00000000?0000?00
00?00000X000?X?0
0?X?0000X0000?00
00?0?000X000?000
0000?0000X00?000
0000X0000X00X000
000X00000X00X000
000X00000X0X0000
0000XXXXXXXX0000
00000XXXXXX00000
0000000000000000
