#uuid#c6865b11-1233-4ca9-8ba2-fe527038cd7a
#name#jar
#title#Sweet Nectar
#difficulty#0
#data#
00000000000XX000
0000000000XXXX00
00000?00000????0
0000X0X00XXXXX?0
0000X00XX00X0000
0000X00X0000X000
0000X0X00000X000
0000??00000??000
0000X000000?XX00
0000X00000X?0X00
000X00000XX00?00
000X0000X00?X?00
00X000XX00000000
00X0X?0000000000
00XX000000000000
0000000000000000
