#uuid#f273f74f-627e-4036-9912-1f4189ce76e1
#name#jellyfish
#title#Jellyfish
#difficulty#0
#data#
0000000000000000
0000000000000000
0000000XXXX00000
00000XX0000X0000
0000X0000000X000
0000X00000000X00
000X000000000X00
000X000000000X00
000X000000000X00
000X000000000X00
00?0X00000000X00
0?0?0X000000X000
?0?0?0X000XX0000
0?0?0?0XXX0?0000
?0?0?0?0?00?0000
?0?0?0?0?0?00000
