#uuid#28101bf2-c4f8-467f-9793-73624d03e124
#name#labyrinth
#title#Labyrinth
#difficulty#0
#data#
0000000000000000
0X??X??XXXX00000
0?00000000?00?00
0?00000000?00?00
0X00X??X00X00X00
0X00X00X00X00X00
0X00X00X00000X00
0X00X00X00000X00
0X00X00XXXXXXX00
0X00X00000000000
0X00X00000000000
XX00X??XXXXXXXXX
0000000000000000
0000000000000000
XX??X??XXXXXXXXX
0000000000000000
