#uuid#e9eb81d1-c2e8-4f94-8b33-c15dcf77fc59
#name#ladybird
#title#Ladybug
#difficulty#0
#data#
0000000000000000
0000000000000000
0000000?00XXXX00
0000000000XXXX00
000XX0000000XX00
000000X?0000XX00
000000X?00000000
0X00XX000?000000
0X00XX00?0XX0XX0
0000000?00XX0000
000000?000000000
00000?0XX0000000
0000000XX00X0000
0000000000000000
00000000X0000000
00000000X0000000
