#uuid#4288ed37-9499-4e64-952d-42d7c7259a31
#name#leaf
#title#Green Leaf
#difficulty#0
#data#
0000000000000000
0000000000000000
00000000X0000000
00000000X0000000
0000000?X0X00000
0000?0?0X0XX0000
000?0?000?00XX00
0000?0000000X000
000?00?0000?0X00
0000X00000?0?000
0000?0000?00X000
00000XXXXXX?0000
00000000X0000000
00000000X0000000
0000000X00000000
0000000000000000
