#uuid#091f85ec-5d08-4d5e-8a31-f0bc192b76d1
#name#lion
#title#Lion
#difficulty#0
#data#
0000000000000000
0000000000000000
0000000000000000
000XXX000000XXX0
00X00XXX00XXX00X
00X0XXXXXXXXXX0X
00XXXXXXXXXXXXXX
000X000XXXX000X0
0000000XXXX00000
0000000XXXX00000
00000000XX000000
0000?0?0000?0?00
00000???00???000
000000??00??0000
0000000000000000
00000000XX000000
