#uuid#4cc05d74-f4a5-4e4d-aba6-358748133579
#name#lion2
#title#Lion
#difficulty#0
#data#
000000XXXX000000
000X0X0000XXX000
00X000000000X000
00X000XXX0000XX0
0?000X000X0000X0
?000000000X000X0
?00X0000000X00X0
0?0?00??000X000?
X00X0?00?00?000?
X00X0000000?000?
X00X0000000?00?0
0X0X00??000?00X0
0X00X00000?000?0
0X000X000?000?00
0?0000???000?000
00?00000000?0000
