#uuid#978a5e7d-3d87-440f-828e-7ab6be123c04
#name#lips
#title#Kiss
#difficulty#0
#data#
0000000000000000
0000000000000000
0000000000000000
00000000XXXXXXXX
0000000XXXXXXXX0
0000XXXXXXXXX000
000XXXXXXX000000
000XXXXX0000??00
00XXX000000???00
0XXX00000?????00
0XX0000??????000
0X000????????000
000?????????0000
000000????000000
0000000000000000
0000000000000000
