#uuid#3c77af7d-db40-4c58-99be-27ba2663def5
#name#marathon
#title#Runner
#difficulty#0
#data#
0000000000000000
00000XX000000000
00000XX?00000000
00000X??00000000
000000?00X?X0000
000000??00?00000
0000???????00000
000??0????000000
000??00XX0000000
000000XXXXX00000
000000XX0XXX0000
XXX00000XX00XXXX
XXX0000XXXX00XXX
XXX0XXXXXXX00XXX
XXXXXXXXXXXXXXXX
XXXXXXXXXXXXXXXX
