#uuid#855bfdc1-af71-402c-a787-83843e239013
#name#menhir
#title#Menhir
#difficulty#0
#data#
0000000000000000
0000000X00000000
000000X0X0000000
000000X0?0000000
000000X00?000000
00000XX00?000000
00000XX000000000
00000XX000?00000
00000XX000X00000
XXXXXXX0000XXXXX
00000XX0000X0000
00000XX0000X0000
00000????00?0000
000000XX?XXX0000
0000000000000000
0000000000000000
