#uuid#7039936e-5790-4f9a-aa05-c459c27e8097
#name#minotaure
#title#The Minotaur
#difficulty#0
#data#
0000000000000000
00X000000000X000
00X0000000000X00
0XX0000000000X00
0XX000XXXX00XX00
00XXXXXXXXXXX000
000XXXXXXXXX0000
0000XXX0-0XX0000
0000XX0000000000
0000X00000?00000
000X00000?000000
000X0000?0000000
000X000?00000000
00XXX0?000000000
00XXX?0000000000
0000000000000000
