#uuid#00e778e4-b413-4d80-ab57-adb713088db6
#name#mirror
#title#Mirror
#difficulty#0
#data#
000000XXX0000000
0000??000X000000
000?000000X00000
00?00000000X0000
00?00000000X0000
0?000000000X0000
0?000000000X0000
00?0000000X00000
000?00000X000000
0000?XXXXX000000
000000000X000000
000000000XX00000
0000000000X00000
0000000000XX0000
00000000000X0000
0000000000000000
