#uuid#0e7b699c-fec3-4978-8198-b52317eccebd
#name#moon
#title#Moon
#difficulty#0
#data#
00000000XX000000
0000000000X?0000
000000000000X000
0000000000000?00
00000000000000X0
00000000000000?0
0000000000000X00
00000000000??0?0
000000000??0??0X
0000000XXXX0XX0X
00000000000?000X
0000000000X?X000
0X000000000?00?0
00X0000000000X00
000X00000000X000
0000000XXXX00000
