#uuid#19b625a3-1f65-462d-8cd9-1c98d7290eed
#name#mountain
#title#Mountain
#difficulty#0
#data#
0000000000000000
0000000000000000
0000000000000000
0000000000000000
00000000???00000
000000XX000?0000
00000X000000?000
XXXXX00X?0000X00
00000XX00???00?0
XXXXX0000000X00X
00000XXX??000??0
XXXXX00000?00000
00000000000X???X
0000000000000000
0000000000000000
0000000000000000
