#uuid#45ee24cb-1dee-41eb-96fc-cc8e5f450720
#name#nil
#title#The Nile
#difficulty#0
#data#
0000000000000000
0000000000000000
0000000000000000
0000?00000000000
0000X00000000000
0000XX0000000000
0000XX0000000000
000XXXX00000000?
000XXXX00000?0?0
000XXXXX000?0000
000XX0000000?000
0000000000000?00
00000000?0?0?000
00000?0?0?000000
00?0?0?000000000
0?0?000000000000
