#uuid#c810fecc-af88-4360-8530-ef5044acd08d
#name#olympic
#title#Olympic Rings
#difficulty#0
#data#
0000000000000000
0000000000000000
0000000000000000
0000000000000000
0++++000000++++0
++00++0000++00++
+0000X0000X0000+
+00??X0000X?X00+
++0?XX0000XX?0++
0XXXX00?000XXXX0
0000000?00000000
00??00?X?00??000
000????0????0000
0000000000000000
0000000000000000
0000000000000000
