#uuid#ca4440b4-88ba-4e9b-8bd0-ef6153a803c6
#name#ornament
#title#Ornament
#difficulty#0
#data#
0000000000000000
0?00??000??00??0
00??00??00??000?
000??00??000??00
0000??00??000??0
0?000XXXXXXXXXXX
0??0?X0000000000
0?00?X0XXXXXXXXX
000?0X0X00000000
00???X0X00000000
0??0?X0X00000000
0?00?X0X00000000
000?0X0X00000000
00??0X0X00000000
0??0?X0X00000000
0?00?X0X00000000
