#uuid#f2b130df-cdd6-4d46-a5a2-25516e2251ef
#name#ostrich
#title#Ostrich
#difficulty#0
#data#
0000000000000X00
000000000000XXX0
000000000000XX00
000000000000X000
000000000000X000
00000X??0000XX00
000?000?X?000?00
00??00000??0??00
0X00??00000?X000
0000?0?00X??0000
00000??X00000000
000000X?00000000
000000X??0000000
000000X00??00000
000000X000?00000
X0X0X0X0X0X0X0X0
