#uuid#f3f9bf5e-2154-4cc3-8184-a88f55b70811
#name#owl
#title#Owl
#difficulty#0
#data#
0XX0000000000XX0
00X000000000XX00
00XX???????XX000
0000000000000000
00X000000000XXX0
0X00000000000XXX
0X00000000000X00
0X0X?00000?X0X00
0X0X-00000-X0X00
0X00000000000X00
00X0000X0000X000
00X0000?0000X000
000??00000??0000
0000?00000?00000
0000??X0X??00000
000000X0X0000000
