#uuid#2f802b0e-539a-4106-b5f2-3c0c747cad8d
#name#padlock
#title#Padlock
#difficulty#0
#data#
0000000000000000
000000XXX0000000
00000XXXXX000000
0000XX000XX00000
0000XX000XX00000
000000000S?00000
0000XX???XX00000
000S0000000S0000
00X000???000X000
00X000???000X000
00X0000?0000X000
00X0000?0000X000
00X0000S0000X000
00S0000000000000
00XXXX???XXSX000
0000000000000000
