#uuid#d519fbdd-0597-492d-b841-3ab1e9c6c8e8
#name#palmtree
#title#Palm Tree
#difficulty#3
#data#
0000000000000000
00000XXX00000000
0000XXXXX0000XX0
00000000XX00XXXX
000000XXXXX0?000
0000XXX000X?0XX0
0000??000???X0XX
000X?00XX?X0X000
000X00XX0?X00X00
000000X0X?0000X0
00000000??0000X0
0000000X?00000X0
0000000??0000000
000000X?00000000
000000??00000000
0000000000000000
