#uuid#ced57cb9-45c7-4410-9151-46495fb6ae65
#name#pan
#title#Pan Lost His Flute
#difficulty#0
#data#
0000000000+X0000
000000000X00X000
00000000+X00X000
000000++0X?0+000
0000XX0000XXX000
000+00+00++00000
0++000+00+0XX000
00+00X0XX000X000
0000++-0+0000+00
0000XX+XX0000000
0000XX+XX0000000
0000XX0XX0000000
000XX00X00000000
000XXX0XX0000000
00000X000X000000
00000X+000+00000
