#uuid#9ca08a3c-9957-412a-8bfe-2f734eb3549e
#name#panpipes
#title#Pan Flute
#difficulty#0
#data#
0000000000000000
0?XXX?XX?XX??X?0
?00000?0?00?00?0
X0000000000000?0
?0000000000000X0
X?XXX?XXXXXX?X00
0?0000X0?00?0000
0X0000X0XXX00000
0X0000X0X0000000
0X0000X?00000000
0X000X0000000000
0X00X00000000000
0X0X000000000000
0XX0000000000000
0X00000000000000
0000000000000000
