#uuid#d240a0e5-7cfb-4dd4-aa58-4b4365ac8aaa
#name#parchment
#title#Parchment
#difficulty#0
#data#
0XX?X?XXX?X?XX00
?0000000000000X0
?0000000000000X0
0XX?X?XXX?X?XX00
0000000000000000
0000000000000000
0000?????0000000
0000000000000000
00000?????000000
0000000000000000
00000000????0000
0000000000000000
00XX?X?XXX?X?XX0
0X0000000000000?
0X0000000000000?
00XX?X?XXX?X?XX0
