#uuid#e2cbeff8-931a-4f5d-8e23-15386dae5d62
#name#parchment_b
#title#Scroll of Victory
#difficulty#0
#data#
0000000000000000
00000000XX?00000
000XXXX?000???00
00XXX0000000?000
0X000X0000XX0000
0X0000X0XX0X0000
00?0000?0000?000
000?000000X0X000
0000?000??000?00
00000?000X0X00?0
000000?00??0?0?0
0000000?000X00X0
00000X?0X0000X00
000?X000X00X?000
0000XX000??00000
000000???0000000
