#uuid#7dcd1020-be34-4879-9150-e496b3b4c348
#name#pattern
#title#Pattern
#difficulty#0
#data#
XXXXXXXXXXXXXXXX
0000000000000000
XXXXXXXXXXXXXXXX
?00000XXXX00000?
0?000?0000?000?0
00?0X000000X0?00
000X00000000X000
000X000XX000X000
000X000XX000X000
000X00000000X000
0000X000000X0000
00000?0000X00000
000000????000000
0000000000000000
0000000000000000
0000000000000000
