#uuid#2993d8e0-dbc9-4166-9bab-daff66516cd3
#name#pears
#title#Pears
#difficulty#0
#data#
0000000?00000000
00000000X0000000
00000000X0000000
00000000XX000000
0000000?0X000000
00000000X0X00000
00000000X0X00000
00000000X0X00000
000X???0?00?0000
00X0000?000X0000
0X00000?0000?000
?000000?00000?00
X000000?00000X00
0XX000X?00000?00
000XXX00?000?000
000000000XXX0000
