#uuid#69c7258e-40f7-4d96-93b6-e2c5dbe25bd1
#name#pick
#title#Icepick
#difficulty#0
#data#
0000000000000000
0000000000000000
0000000X000???00
000000X0X??000?0
000000X0?000??00
000000?000??0000
00000?0000X00000
000??0??00X00000
00?00?00X00X0000
00?0?000X00X0000
000?00000X00X000
000000000X00X000
0000000000X0X000
0000000000X00X00
00000000000X0X00
00000000000XXX00
