#uuid#4b3ffc5d-35e5-4757-af8f-0549e27f12a1
#name#planet
#title#Planets
#difficulty#0
#data#
0000000000000000
000000???0000000
00000X0?0X0000?0
0X000?0X0?000000
00000?????000000
000000X?X0000000
0000000000000000
000?000000?X?000
00?X?0000X000X00
000?0000?00000?0
00000000X00X00X0
000000?0?00000?0
000000000X000X00
000X000000?X?000
0000000?000000X0
0000000000000000
