#uuid#5abdd1da-5b80-422f-9adf-d162a4a31d1b
#name#poplars
#title#Poplars
#difficulty#0
#data#
000?0000?0000?00
00X?000X?000X?00
00?0000?0000?000
00X0000X0000X000
00X0000X0000X000
00X0000X0000X000
00?0000??000?000
00??00??0X00??00
0??0X0?00X0??0?0
0?00X0?00X0?00X0
0?00X0?00X0?00X0
0?00X0?00X0?00X0
0?00X0?00X0?00X0
00X?000X?000X?00
0000000000000000
0000000000000000
