#uuid#b23bbda1-64a9-4b94-94fd-4aa1cec93f45
#name#pork
#title#Piggie
#difficulty#0
#data#
0000000000000000
0000000000000000
00XX000000000XX0
00XXX0000000XXXX
0X00XXXX?XXXX00X
0X000X00000?0000
00000X000000X000
0000X00X00X0X000
000X00000000X000
00XX000000000XX0
00X0000X?X0000X0
00XX0000?0000XX0
000XX000?000XX00
00X?0000?0000?X0
00?0?0X000X0?0?0
00?00?0?0?0?00?0
