#uuid#e9fb555b-febc-4ba8-a60c-37a6064d9c28
#name#pot
#title#Striped Pot
#difficulty#0
#data#
0000000000000000
0000000000000000
0000000000000000
0X?0000000000??0
0?0X?X?X?X?X?0X0
0X000000000000?0
0?000000000000X0
0X000000000000?0
00?0000000000X00
00X0000000000?00
00?0000000000X00
00X0000000000?00
000?00000000X000
0000X?X?X?X?0000
0000000000000000
0000000000000000
