#uuid#bc978160-42c6-4966-970b-7ba0b52ed31e
#name#pot2
#title#Cauldron
#difficulty#0
#data#
0000000000000000
0000000000000000
000XXXXXXXXXX000
00X0000000000X00
00X0000000000X00
000?X000000XX000
00?00XXXXXX00?00
0X000000000000X0
0X000000000000X0
0X000000000000X0
0X000000000000X0
0?00000000000?00
00??0000000??000
0000XXXXXXX00000
0000000000000000
0000000000000000
