#uuid#beb74c7c-375f-46eb-b758-2decb9f68425
#name#pot3
#title#Smelly Soup
#difficulty#0
#data#
0000000000X00000
000000000X000000
00000000X0000000
00000000X0000000
000000000X000000
000?XXXXSXXXX??0
00?000000000000?
000?XXXXSXXX00?0
000?0000000000X0
00X00X00000000X0
00X0X000000000X0
0?00X0000000000?
00?000000000X00?
000?0000S000?0?0
0000XXXXSXXXXX00
00000X00S0X00X00
