#uuid#be5134e3-8435-4c2c-8ea3-115e1dd973d8
#name#pyramide
#title#Pyramid
#difficulty#0
#data#
0000000000000000
0000000000000000
0000000000000000
0000000000000000
0000000XX0000000
000000XX0X000000
000000XX0X000000
00000XXX00X00000
0000XXXX00XX0000
000XXXXX0X0XX000
00XXXXXXX0000000
000XXXXX000S0000
00000XX000S00000
0000000X0S000000
0000000XS0000000
0000000000000000
