#uuid#90cd0291-e76f-4eb3-b375-b9f110065328
#name#question
#difficulty#2
#data#
0000000000000000
00000XXXXXX00000
0000XX0000XX0000
000XX000000XX000
000XX000000XX000
0000XX00000XX000
00000XX000XX0000
000000000XX00000
00000000XX000000
0000000X?0000000
0000000X?0000000
0000000X?0000000
0000000000000000
0000000??0000000
0000000??0000000
0000000000000000
