#uuid#3b244758-2a03-4e46-9da2-420c9a3473d7
#name#rain
#title#Rain Cloud
#difficulty#0
#data#
0000000000000000
00000000000??000
0000000000?00?00
00???00???0000?0
0?000??00000000?
?00000000000000?
X00000000000000X
0XXXXXXXXXXXXXX0
0?0000000000?000
00S00X00?0000S00
000000X00S000000
00000000000X00X0
00000X00?000X00X
00?000X00S000000
000S000000000?00
00000000000000S0
