#uuid#b1018a5e-674f-42af-a1ea-1f6bb0ad33e2
#name#ring
#title#Ring
#difficulty#0
#data#
000000000??00000
00000000????0000
0000000000???000
0000??????00?000
000X000000XX0000
00?00??????0?000
00X0X000000X0?00
00XX00000000?X00
00XX000000000XX0
00X0000000000XX0
000X000000000XX0
000??0000000?0X0
000X0XX000XX00?0
0000X00XXX000?00
00000XX0000X?000
0000000XXXX00000
