#uuid#c426edbd-a0ac-4510-b009-de8960925c81
#name#risingsun
#title#Sunrise
#difficulty#2
#data#
0000000000000000
000X000X000X0000
0000000000000000
0X000000X00000X0
0000X0000000X000
0X0000X000X00000
000?0000000000X0
000000????00?000
00000?0000?00000
0X00?000000?00X0
000?00000000?000
000X00000000X000
000X00000000X000
0000000000000000
0000000000000000
0000000000000000
