#uuid#5802d28b-d6a1-4dd3-bc4d-156fea10deef
#name#road
#title#Road to Nowhere
#difficulty#0
#data#
0000000000000000
0000000000000000
0000000000000000
0000000000000000
0000000000000000
XXXXX000000XXXXX
XXXXX0????0XXXXX
XXXX00?00?00XXXX
XXXX00?00?00XXXX
XXX00?0000?00XXX
XXX00?0000?00XXX
??00?000000?00??
XX00?000000?00XX
?00?00000000?00?
X00?00000000?00X
00?0000000000?00
