#uuid#105ef827-f46e-4c9d-92be-f509d2fdec36
#name#rose
#title#Rose
#difficulty#0
#data#
0000000000000000
0000000000000000
0000000000XX0000
0000000000?0??00
000000000?0000X0
000000000?0000X0
000000000XX00?00
0000000000???000
0000XX000X000000
0000X?00X0000000
000000XX00000000
00000?00?X000000
0000X000XXX00000
0000?0000X?00000
000X000000000000
000?000000000000
