#uuid#4e39efc6-c2fd-4ba4-a275-8602f0f20ba6
#name#saturn
#title#Saturn, the Planet
#difficulty#0
#data#
0000000000000000
00X0000000000000
00000X0000000X00
0000000000000000
00000?????0000X0
0000?00000?00000
000?0000S00X0000
000?000S0S0X??00
00?X0000S00X00?0
0?0X0000000???00
00?????????X0000
0000X00000X00000
00000XX???00X000
0X00000000000000
00000000000X0000
0000X00000000000
