#uuid#9b167d37-722d-4531-9e5b-de4026c53d2e
#name#scorpio
#title#Scorpion
#difficulty#0
#data#
000000000XX00000
000000000X000000
00000000XXXX0000
0000++0XX0000000
00+00+0X000000X0
00++0+XXX000X0X0
000+00X0XX00XXX0
+000+S0XXX00XX00
+000+0XX0XXXX000
0+0XX+0++00+0000
00XX0+00+0000000
0++00++00++00000
0+0000++00000000
0XX0000000000000
00XXX-X000000000
000XXX0000000000
