#uuid#83992796-ba74-4e2c-aa69-a2249a126b73
#name#seagull
#title#Seagull
#difficulty#0
#data#
0000000000000000
0000000000000000
0000000000000000
00000000XX000000
000000X??XX00000
00000?0??XX00000
000??00000X00000
00?????X00X00000
00??0000?0X00000
0000000X00X00000
0000000X000XXXXX
000000X000000000
000000X000000000
000000X000000000
000000X000000000
0000000X00000000
