#uuid#ea082ffc-8e23-475c-a2a3-d7e684b9efe2
#name#seahorse
#title#Seahorse
#difficulty#0
#data#
0000000000000000
00000000XX000000
0000000X00?00000
0000000X00?00000
000000X000?00000
000000000X?00000
00000000XX000000
0000000XX0000000
0000000XX0000000
0000000XX00X0000
000000XX00?0?000
000000XX00?0?000
000000XX0000?000
0000000??00XX000
00000000????0000
0000000000000000
