#uuid#3df1eb6a-0f65-4ee8-84cb-7ff3b0142bc2
#name#sharck
#title#Shark Fin
#difficulty#0
#data#
0000000000000000
0000000000000000
0000000000000000
0000000000000X00
00000000000XX000
000000000XXXX000
000000000XXX0000
0000000?00XX0000
000000?00XXX0000
00000?00XXX00000
00000X0XXXX00000
0000XXXXXXX00000
0000XXXXXXXX0000
00XXXXXXXXXXXXXX
0000000000000000
0000000000000000
