#uuid#6f7a6e5d-3b59-4004-ae8e-2913ed270e5d
#name#shellfish
#title#Scallop
#difficulty#0
#data#
0000000000000000
0000000000000000
0000XXXXXX000000
00X?000000??0000
0X0000000000X000
0X00000000000X00
0X000000000000X0
0X000000000000X0
0X000000000000X0
00X00000000000X0
00X00000000000X0
000?00000000XX00
000X0000000?0000
0000X0000X?00000
00000XXXX0000000
0000000000000000
