#uuid#5f9216ca-85b8-440c-b4cd-cf365b1eacf2
#name#shell
#title#Pearl
#difficulty#0
#data#
0000000000000000
0000000???000000
0000XX?000?00000
000X0000000?0000
00X000000000?000
00X0000000000?00
00X0000000000?00
00X0000000000?00
000X00000000??00
0000X000000X0000
0000X00??00X0000
0000X0????0X0000
0?00000??00000?0
00X000000000XX00
000XXXXXXXXX0000
0000000000000000
