#uuid#171df5ed-66b1-46e3-875f-7226a73fcc3a
#name#shield
#title#Studded Shield
#difficulty#0
#data#
0000000000000000
0000000X?X000000
0000000???000000
0000000-?X0X?X00
000X?X00000???00
000???00000-?X00
000-?X0000000000
0000000000000000
00000000000X?X00
000X?X00000???00
000???00000-?X00
000-?X0X?X000000
0000000???000000
0000000-?X000000
0000000000000000
0000000000000000
