#uuid#6de422f7-14cf-4061-94d3-67bda38b6523
#name#sirena
#title#Siren
#difficulty#0
#data#
0000000000000000
00000000X0000000
000XXXXX00000000
000??X0000??0000
0000?000??000000
000000XXX0000000
00000XXX00000000
0000?XX?00000000
000??0??XX000000
00?0000XXXXX0000
00000000XXXX0000
00000000000XX00X
0000000000000XXX
0000000000000X00
000000000000XX00
0000000000000000
