#uuid#07d8c8d6-ee02-44f7-bbbf-a13317e1bfa2
#name#skull
#title#Forever Smiling
#difficulty#0
#data#
00000??????00000
0000?000000?0000
000X0?????00X000
000S000000?0X000
000X00000000X000
000X00000000X000
00X00??00??00?00
00S000?00?000?00
00S0000000000?00
000X000XX000X000
0000000000000000
00000?0000?00000
000X00????00?000
000X00000000X000
0000X000000X0000
00000XXXXXX00000
