#uuid#5b643676-20f9-4f29-9886-07a18de3b7b4
#name#soldier
#title#Centurion's Helmet
#difficulty#2
#data#
0000000000000000
000000?0?0?00000
0000?00000000000
0000000000000000
00?000XXXXX00000
00000XXXXXXXX000
0000XXXX00XXXXX0
000XXXX00XXXXXX0
000XXXX00XXXXX00
000XXXX000000000
0000XX0??0000000
0000XXX???000000
0000XXX0???00000
000XXXX00??00000
00XXXX0000000000
0000000000000000
