#uuid#9dd5cf73-ac71-435c-b690-341a0ae5fada
#name#soldier2
#title#Soldier on Guard
#difficulty#0
#data#
000000X000?00000
000000X00??00000
000000X00??00000
000000X000?00000
000000?00????X00
000000X00X000X00
000000??0X000X00
000000?0??0?0X00
000000X00X000X00
000000X00X000X00
000000X00X000X00
000000X00X?X?X00
000000X00X0X0000
000000X00X0X0000
000000X00X00?000
000000X0XX00?X00
