#uuid#23e0abc3-0a16-4c35-8504-0aee50132300
#name#soldier3
#title#Charging Soldier
#difficulty#0
#data#
0000000000000000
000000000++00000
00000000+--+0000
0000000+----+000
0000000XXXXXX000
0000000X0XX0X000
0000000000000000
000000000XXXXXX0
00000000X000000X
0000000X00000000
000000X0000X0000
000000?000?0?000
00000?000X00X000
0+-+0?000?0?0000
00X00X0000X00XX0
00X00X000000XXX0
