#uuid#738b3af8-1ea2-44df-8c92-33f5fd44eb3f
#name#spear
#title#Spear Point
#difficulty#0
#data#
0000000000000000
000000000000XXX0
0000000000??XXX0
00000000??0?XX00
000000??00??0X00
0000??000??0?000
0000?000??00?000
0000?00??000?000
0000?0??000?0000
0000XX?0000?0000
0000XXX????00000
000XX00000000000
00XX000000000000
0XX0000000000000
XX00000000000000
X000000000000000
