#uuid#31923f93-19e6-4a14-982d-9d644c6ce48b
#name#stars
#title#Wish on a Star
#difficulty#0
#data#
0000000000000000
000?000000000000
00???0000000?000
000?000000XX?XX0
00000000000X?X00
00000000000X0X00
000000?000000000
000000?000000000
0000XX?XX0000000
00X?XX?XX?X00000
0000XX?XX0000000
0000XX?XX0000000
000XXX?XXX000000
000XX000XX000000
0000000000000000
0000000000000000
