#uuid#e8f8d438-5b68-4162-b5ba-efd1ea11ab05
#name#statue
#title#Statue
#difficulty#0
#data#
000000XXX0XX0000
00000??00000?000
0000X00000000X00
0000X00000000X00
0000X0XXX?XX0X00
0000X0000?000X00
0000X0000?000X00
0000?0000?000X00
0000??000000??00
00000?X0000X?000
000000XX000?0000
0000000XX00X?000
00000000X000??00
00000000X0000XXX
00000000X0000000
00000XXXX0000000
