#uuid#337ea833-db99-4d36-a4fa-a372e964f29d
#name#statue2
#title#Discus Thrower
#difficulty#0
#data#
0000000000000000
000XX00000XXS000
00XXX000XXX0S000
00XXX00XX0000X00
000SSSSS00000SS0
0000XXXXX000X00X
00000X0XXX00X00X
0000XX00XXX00XX0
0000S0000SS00000
000XX00XXXX00000
00XX00XX00X00000
00S00SS000SS0000
00X000XX000SX000
0000000X0000XXX0
0000000XX00000X0
00000SSXX0000XX0
