#uuid#158a84d1-252d-46e4-98c1-50d60f610e2c
#name#stoneway
#title#Via Appia
#difficulty#0
#data#
000XXXX00XXXXXXX
00XXXXXX000XXXX0
0XXXXXXXX000XX00
0XXXXXXXX000XX00
0XXXXXXXX0000000
00XXXXXX000000XX
000XXXX00000SS00
0000XX0000SS0000
0000XX000S000000
0000000XX0000000
00000SS000000000
000SS00000000000
00X0000000000000
XX00000000000000
0000000000000000
0000000000000000
