#uuid#1951ea3d-d38f-45f6-b80f-020fde152aac
#name#stool
#title#Stool
#difficulty#0
#data#
0000000000000000
0000XXXXX?X00000
000X0000000?0000
000X??000???0000
000X00???00?0000
0000?00000?00000
0000??XXXX?00000
0000?00?00?00000
0000?00?00X00000
000X000X000X0000
000X00X0000X0000
000X00X0000X0000
00X000X00000X000
00X000X00000X000
000000X00000X000
0000000000000000
