#uuid#ca81a4b2-52f1-47c9-aa28-963792b5d8bb
#name#storm
#title#Lightning Strike
#difficulty#0
#data#
000000X?00000000
00000000-0000000
000000000XX00000
00000000000X0000
00000000XXX00000
0000000X00000000
000000-X00000000
00000000?0000000
000000000-000000
000000000X000000
00000000X0000000
00000000?0000000
000000000X000000
0000000000000000
XXXXXXXXX00XXXXX
XXXXXXXXX0XXXXXX
