#uuid#14e8fffd-bf3a-4cf4-ab56-061cad666417
#name#strawberry
#title#Strawberry
#difficulty#0
#data#
0000000000000000
0000000000000000
0000000000000000
0000000000000000
0000XXX000XX?000
000X000X0X000X00
00?00000?00000?0
00X00000000000X0
00X00000000000X0
000X000000000X00
0000X0000000X000
00000X00000X0000
000000X000X00000
0000000X0?000000
00000000?0000000
0000000000000000
