#uuid#07c76abf-0dc1-4ce1-86f7-2be669a27031
#name#sun
#title#Sun
#difficulty#3
#data#
0000000000000000
0000000000000000
0000000?00000000
000000000000?000
000?00X????00000
00000X00000X0000
0000?0000000X0?0
0000?XXX00XXX000
00?0?0000000X000
0000?0000000X000
0000X00XXXX0X000
00000X00000X00?0
000?00X????00000
000000000000?000
00000?000?000000
0000000000000000
