#uuid#8df2dd18-3cac-43f0-9638-d711233f0fb7
#name#sun2
#title#Sunny Day
#difficulty#0
#data#
0000000000000000
0000000000000000
X000000XXX000000
X00000XXXXXX0000
XX000?XXXXXXX000
???0?0XXXXXXX000
XXXXX00XXXXXX000
S???0S0?00000000
00000XXXXXXXX000
00000XXXXXXX00XX
000000XXXXX0XXXX
000000000000XXXX
00000000XX0XXXXX
0000000XXXXXXXXX
000X?XX0XXXXXXXX
0000000000000000
