#uuid#6b057102-82bb-4d16-8e13-477e2694711b
#name#sundial
#title#Sundial
#difficulty#0
#data#
0000000000000000
0000000000000000
0000000X00000000
0000000X00000000
0000000X00000000
0000000X00000000
0000000X00000000
00000000S0000000
0X0000000SS000X0
00S00000000S0S00
000SSS00000SS000
00000SSSSSS00000
0000000000000000
00000X00000X0000
00000X00000X0000
00000X00000X0000
