#uuid#c11f8d9c-f20a-4abb-94f4-6f4e56c8c2a8
#name#sword
#title#Fine Sword
#difficulty#0
#data#
0000000000000000
XX00000000000000
XXX0000?00000000
0XXX00X??0000000
00XXXXX000000000
000XXXX000000000
000XXXX?00000000
00XX0XX0?0000000
000X00X00?000000
0000000X00?00000
00000000X00?0000
000000000X00?000
0000000000X00?00
00000000000X00?0
000000000000X0XX
0000000000000XXX
