#uuid#ad611874-7649-4461-a212-24bb681b421e
#name#sword3
#title#Sword Hilt
#difficulty#0
#data#
00000000000XXX00
0000000000X000X0
0000000000X000X0
0000000000X000X0
0000000000-XXX-0
00000000000X-X00
00000000000X-X00
000000000000?000
00000000000X0X00
000000000000?000
00000000000X0X00
00000XX0000X0?00
00000X0XX?X000XX
000000X000X000X0
0000000000X000X0
0000000000X000X0
