#uuid#0b6b6042-0414-47c8-bba7-2ffe260e7f98
#name#sword2
#title#Sword
#difficulty#0
#data#
0000000000000000
00000000000000?0
0000000000000?0?
000000000000?00X
0000000?X00?0?X0
0000000?0X?0?000
00000000?0??0000
00000000??0X0000
0000000X?0?0X000
000000XX000??000
00000XX000000000
0000XX0000000000
000XX00000000000
00XX000000000000
0XX0000000000000
XX00000000000000
