#uuid#13a0083a-656f-4f26-9b2e-a2652bd6580e
#name#tablet
#title#Stone Tablet
#difficulty#0
#data#
0000000000000000
000000????????00
00000?00000000?0
0000?0XXXXXXX0?0
0000?000000000?0
000?0XXXXXXX0??0
000?000000000??0
00?0XXXXXXX0??00
00?000000000??00
0?0XXXXXXX0??000
0?000000000??000
0???00000???0000
0??????????00000
00????????000000
0000000000000000
0000000000000000
