#uuid#922a2a28-15c0-48f5-bd3a-c27434667d63
#name#tart
#title#Slice of Pizza
#difficulty#0
#data#
0000000000000000
0000000000000000
0000000000000000
0000000000000000
0000000000000000
0000000000000000
00000XX?00000000
0000X00?000XX000
00?X000?00X00?00
0X00000?0X0000X0
0?00000??00000?0
0X000000000000X0
00?0000000000?00
000XXX00000XX000
000000X?XXX00000
0000000000000000
