#uuid#191f375d-6b2f-4d9b-ab14-e8938d9eede7
#name#temple
#title#Temple
#difficulty#0
#data#
00000000?0000000
0000000X?X000000
00000??000??0000
000XX0000000XX00
00?????????????0
0000000000000000
000XX0?X0XX0XX00
000XX0?X0XX0XX00
000XX0?X0XX0XX00
000XX0?X0XX0XX00
000??0??0??0??00
000XX0?X0XX0XX00
000XX0?X0XX0XX00
000XX??XXXXXXX00
0XXXX??XXXXXXXX0
XXXXX??XXXXXXXXX
