#uuid#b8e9cf30-284f-4068-ae27-1483a76ca4db
#name#torch
#title#Torch
#difficulty#0
#data#
0000000000X00000
0000000000000000
0000000X00X00000
000000000XX00000
0000000X0XX00000
000000X0XX0X0000
00000X00000X0000
00000X0000XX0000
0000X0000XX00000
0000?0??000X0000
00000?--?00X0000
0000?--?00X00000
000?--?0??000000
00?--?0000000000
0?--?00000000000
?--?000000000000
