#uuid#d243aa07-d316-4240-b157-36164a9f01e9
#name#toutankhamon
#title#Eye of the Pharaoh
#difficulty#0
#data#
0000000000000000
00000XXXXXXX0000
000XX000000XXX00
00+00000000000X0
00+??000000?0000
0+0?S00000?S?000
00000?0000?00000
000000++++++000?
0000++0XXXX0+00S
?00++00XXXX0+000
0+++0000XX00++00
00000?0000000000
0000??0000000000
0000S00000000000
0000?00000000000
0000?00000000000
