#uuid#a762ef29-f9c8-465d-a52c-1cf5b0cd8854
#name#tree
#title#Shady Tree
#difficulty#0
#data#
0000000??0000000
000000X00X000000
000000X00X000000
00000?0000X00000
0000?000000XX000
000?00?00000X000
000?000??0000X00
000??0000000X000
00?00X0000X00XX0
0X??X000X0XX0X00
0000XXXXXXXXX000
0000000XX0000000
0000000XX0000000
XXXXXXXXXXXXXXXX
000000X0XX000000
0000000000000000
