#uuid#64fbe61e-d91b-44bd-b07d-cbd942893cf7
#name#triskell
#title#Triskele
#difficulty#0
#data#
0000000000000000
0000000000000000
000000X???000000
00000X0?00?00000
00000X0?00?00000
00000X0?00?00000
00000X00??000000
000000X000XX0000
00??000??X00X000
0?00?00??0000X00
0?00?00X00????00
0?00?00X00?00?00
00??00X000?00?00
00XXXX00000??000
0000000000000000
0000000000000000
