#uuid#e0e61b21-685b-4c41-9d2c-bdee12f99ae6
#name#triumpharch
#title#Triumphal Arch
#difficulty#0
#data#
0000000000000000
0000000000000000
000?00??00?00?00
0000000000000000
0000000000000000
0000000000000000
0000000000000000
0000000000000000
0000000?XX000000
000000X000?00000
000X00X000?00X00
000?00?0000X0XX0
000X00X0000X0XX0
000X00X0000?0??0
0XXXX0X0000X0XX0
X0000XX0000XX00X
