#uuid#c8481389-7434-4e96-9874-6b8acea26707
#name#trojan-horse
#title#The Trojan Horse
#difficulty#0
#data#
0000000000000000
00000000000X0000
000000000?X0X000
00000000?0000X00
0000000?00XXXX00
000000?00X000000
0000??000X000000
XXXX0000X0000000
00X00000X0000000
00X0000?X0000000
00X0XXXXX0000000
00XX0000X0000000
00X00000X0000000
0XXX000XXX000000
0X0X000X0X000000
0XXX000XXX000000
