#uuid#db22cd46-5547-4fff-b2bc-870bf5e9385e
#name#trumpets
#title#Trumpets of Glory
#difficulty#0
#data#
0000000000000000
000000X000000000
00000?0000000X00
0000?0000000?000
000000X0000?0X00
00?0?0X000X0XX00
0?0000X000000000
X00XXX?000000000
0000000X00000000
00000000X0000000
000000000X000000
0000X00000X00000
000?0000000?0000
00?0X0000000X000
0X0XX00000000X00
00000000000000X0
