#uuid#2dec5504-fa7c-4492-8a3f-b84bdeea55b9
#name#tumbler
#title#Silver Tumbler
#difficulty#0
#data#
0000000000000000
00?XXX????XXX?00
00?0000000000?00
000?00000000?000
000?00000000?000
000?00000000?000
000?00000000?000
00X0000000000?00
00X0000000000?00
000X00000000X000
0000??0000??0000
000000?00?000000
0000?X0000X?0000
000X?X????X?X000
0000000000000000
0000000000000000
