#uuid#2899ab3b-3cc6-41d5-a824-8d0c325dcbc6
#name#turtle
#title#Sea Turtle
#difficulty#0
#data#
0000000000000000
00000000X0000000
0000000XX0000000
0000000XX00XXX00
000000X00X0X0X00
0000?X0000XXXX00
000?0000000X0000
000X0000000X0000
XX?000000000X000
0??000000000XXX0
00X00000000?0000
00?00000000?0000
000?00000XX00000
00XXXXXXX0000000
00XX000XX0000000
0000000XX0000000
