#uuid#48063ab3-c930-4150-af2c-70afb403b9f6
#name#tut1
#title#My Kid Brother
#difficulty#0
#data#
0000000000000000
000000XXXXX00000
00000X00000X0000
00000X00X00X0000
00000X00000X0000
0000X0000000X000
0000X0000000X000
0000X0000000X000
0000X0000000X000
00000X0X??000000
00000X00000X0000
000000XXXXX00000
0000000000000000
0000000000000000
0000000000000000
0000000000000000
