#uuid#352f5933-d655-49cb-a2b3-49ba990ef9a9
#name#tut2
#title#Our Pets
#difficulty#0
#data#
0000000000000000
0000000000000000
0000000000000000
0000000000000000
000000000XXX0000
00000000X?00?000
00000000X000X000
000000000XXX0000
000000000X0X0000
0000000000000000
0000000000000000
0000000000000000
0000000000000000
0000000000000000
0000000000000000
0000000000000000
