#uuid#a8ab68f4-f28f-49da-9aad-1b0376b3d23c
#name#tut3
#title#Ceiling Decorations
#difficulty#0
#data#
0000000000000000
X00000XXXXX00000
0X000?00000?0000
0X00X000000X00XX
00X0X0000000XX00
000X00000000X000
000X00000000X000
000X000000000000
0000000000000000
0000000000000000
0000000000000000
0000000000000000
0000000000000000
0000000000000000
0000000000000000
0000000000000000
