#uuid#bf4be689-8ddd-4559-a0c0-85765fac6354
#name#tut4
#title#Sheep
#difficulty#0
#data#
0000000000000000
0000000000X00000
000000000X0?0000
0000000000X00?00
000000000X00X0X0
0000000000XX0X00
0000000000000000
0000000000000000
0000000000000000
000?000000000000
000X00000X00X000
000X00X00X00X000
000X00X00X00X000
000X00000X000000
0000000000000000
0000000000000000
