#uuid#4acf0f1b-a30a-43db-901a-96df4407fad1
#name#tut5
#title#Fried Chicken
#difficulty#0
#data#
0000000000000000
0000000000000000
0000000000000000
0000000000000000
0000000000000000
0000000000000000
0000000XXXX00000
000000X000X00000
00XXXX0000XXXX00
00000X000X000000
00000XXXX0000000
0000000000X00000
000000000XX00000
00000?00XXX?0000
000000000X000000
0000000000000000
