#uuid#88111c98-a7e1-4c8c-be0d-ca07ddbf9c1a
#name#tut6
#title#Caveman
#difficulty#0
#data#
000000X000000000
000000X000000000
00000X0000000000
00000X0000000000
00000X0000000000
0000X000000??000
0000X0000XX0?000
000X0000X00X0000
000X0000X00X0000
000X000X000X0000
00X0000X00X00000
00X000X00X000000
000XX0X0X0000000
00000XXX00000000
000000XX00000000
00000000X0000000
