#uuid#1ed7710a-4461-4a9f-aefe-a016dd1e8cfb
#name#tut7
#title#Front Door
#difficulty#0
#data#
0000000000000000
0000000000000000
0000000000000000
0000000000000000
0000000?X0000000
000000X00X000000
00000X0000X00000
00000X0000X00000
00000X0000X00000
00000X0000X00000
000000X00?000000
0000000X?0000000
0000000000000000
0000000000000000
0000000000000000
0000000000000000
