#uuid#c1d881d7-fb37-4aad-a1ed-097569b1dabd
#name#tut8
#title#Tree
#difficulty#0
#data#
0000000000000000
0000000000000000
0000000000000000
0000000000000000
0000000000000000
0000000?00000000
000000?0?0000000
00000X000X000000
0000X0X0X0X00000
000X000X000X0000
0000XXX?XXX00000
000000X0X0000000
000000X0X0000000
000000X0X0000000
000000X0X0000000
0000000000000000
