#uuid#0acc1fc1-e39f-474f-a0b0-ef5c3d2ef337
#name#tut9
#title#Prescription Glasses
#difficulty#0
#data#
0000000000000000
0000000000000000
0000000000000000
0000000000000000
0000000000000000
0000000000000000
0000000XXXXXX000
0000000?0000X000
0000000X0000X000
0000000X0000X000
0000000X0000?000
0000000X?XXX0000
0000000000000000
0000000000000000
0000000000000000
0000000000000000
