#uuid#b3f78be1-7533-44da-aa60-3ac197e5aa46
#name#vesuvio
#title#Mount Vesuvius
#difficulty#3
#data#
0000000000000000
0000000000000000
0000000000000000
0000000000000000
0000000000000000
0000000000000000
0000000000000000
0000000XX0000000
00000000??000000
000000XXX0X00000
00000?000??00000
0000XXXXXX00X000
0000000000??0?00
00XXXXXXXX00XXX0
0?000000??????00
XXXXXXXXXXXXXXXX
