#uuid#50af98cb-baf5-459c-9228-b8713d057cc2
#name#wave
#title#The Great Wave
#difficulty#0
#data#
0000000000000000
0000000000000000
00XXXX?XX0000000
XX000X?XXX000000
0000X000XXX00000
000X00000XX00000
000+00000?000000
000+000000000000
000+000000000000
0000X00000000000
00000X0000000000
000000+000000000
0000000XX0000000
000000000XXXXXXX
0000000000000000
0000000000000000
