#uuid#3ab8b730-6bb1-4c1d-93f1-a73daa9cb97e
#name#weapon
#title#War Club
#difficulty#0
#data#
0000000000000000
00000000000X?000
0000000000?00?00
000000000X0X?0?0
00000000?0X0X0X0
0000000?0?0X0?00
00000000?0?0X000
000000000?0?0000
0000000000X?0000
0000000000000000
0000000000000000
0000000000000000
0000000000000000
0000000000000000
0000000000000000
0000000000000000
