#uuid#5e802b0c-aa52-4f66-822b-7ae9ead7a3ea
#name#wheel
#title#Wheel
#difficulty#2
#data#
0000000000000000
0000000S?0000000
0000XXXS-XXX0000
000X00000000X000
00X0000000000X00
00X0000000000X00
00X0000000000X00
0?-0000++0000SS0
0SS0000++0000-?0
00X0000000000X00
00X0000000000X00
00X0000000000X00
000X00000000X000
0000XXX-SXXX0000
0000000?S0000000
0000000000000000
