#uuid#702a80a0-1a57-40c5-93bc-95118dd3e365
#name#why
#difficulty#0
#data#
0000000000000000
0000000000000000
0000000000000000
0000?000000?X000
0000X00000000000
000X?000000?0000
000XX000000X0000
0000XX0000XX0000
00000X0000X00000
00000XXXXXX00000
0000000XX0000000
0000000X00000000
000XXXX0XXXXX000
0XXXXXX0XXXXXXX0
XXXXXX0000XXXXXX
XXXXXXXXXXXXXXXX
