#uuid#5a272f3a-890a-4428-b0c4-ddad671c8318
#name#wind
#title#Windy Season
#difficulty#0
#data#
0000000000000000
000XXXXX00000000
0000000000??XXX0
000000000S000X00
XX?X0000?000?000
0000000?0000?000
??S??????000?000
0000?0000000X000
000?000000000X00
00S0000000000?00
000X?X000000?000
000000X00XX?0000
000000XXX0000000
00000XX000000000
XXXX?XXXXXX?XXXX
XXXX?XXXXXX?XXXX
