#uuid#fcf0f5ef-a3cc-4be4-aa77-4807552459ac
#name#wolf
#title#Wolf Cub
#difficulty#0
#data#
000000000000X000
00XX0000000X0X00
00X0XX0XXXX00X00
00X00?X0000??000
00X0?0000000?000
00X000000000?000
00?0000000000X00
0X0000?000?00X00
0X00000000000X00
00X0000000000X00
00?000000X00?000
XX0?0000XX00?000
0000??00000?0000
000000??00?00000
00000000??000000
0000000X00000000
